S                                  X     X     XX          XX                                        
                           X   X             X              X X X                            X       
               X     X                            X                               X        X         
   X  X  X X          X     X XXX       X                                                 X  X      X
             X                         X        X     X   X       X       X    X     X          X    
  X  X               X                             X   X                       X       X X     X     
      X  X           X X     X      X           X   X                X        X                      
      X X      X                     X  X   X    X   X  X           X      X                    X X  
 X          X X      X       X   X                    X  X   X X          X X    X X                 
  X     X                                                 X        X    X              X      X   X  
      X     X                  X          X       X  X  X      X      X   X                          
                                   X  X              X               X    X                  X       
               X    X   X     X                 X   X        X              X  X                    X
    X                                                                              X  X   X          
    X            X  X        X        X  X  X   X   X  X           X    X XX       XX     X        X 
X            XX   X        X         X    X                    X    X                   X         X  
   X  X       X  X                         X      XX      XX            X             X  X  X     X  
  X     X X     X        XX   XX     X      X X              XX  X                X      X   X       
  X                      X   X        X        X                  X                   X X            
   X        X                   X               X           X   XX                   X           X  X
       X X                         X   X   X   XX   X                            X              X    
                   X                               X X  X                 X  XX                      
    X                               X     X  XXX         X X              X X  X  X         X        
       XX       X                           X   X                                   X                
   X            XX     X  X               X                      X     X                    X       X
    X                   X    X    X    XX   X          X X             X             X      X        
      X      X  X X X        X                    X                       X   X                   X  
X    X      XX       X     X      X                              X             X X  X                
      X    X       X                                  X        X                                    X
                    X  X   X               X              X   X         X        X   X           X  X
                                  X          X          X         X  X XX           X     XX         
      X                 X                 X                               X      X        X   X      
            X           X      X    X                      X  X                 X      X X           
  X     X             X     X        X    X X        X X XX  X    X   X   X         X  X     X      X
                  X                     X                                X        X             X X  
       X    X           X      X       X   XX              X        X       X         X      X  X X  
           X         X     X           X                               X       X              X      
             X      X  XX        X                                    X    X     X    XXXX    X      
          X      X    X XX              X                             X   X        X  XX          XX 
             X                              X       XX    X  X X       X   X             X         X 
       X     X                            X        X              X           X       X X    X      X
                   X  X  X  X              XX                  X                 X   XXX           X 
              X   X            X   X          X              X XX    X   X     X    X           X X  
X        XX    X     X      X      X          XX                   X   X          X   X              
        X               XX   XX         X     X                         X           X          X     
       X         X  X      X        X        X          X        X     X     X          X            
                                  X                  X       X            X          X  X X       X  
       X         X        X   X      X   X                    X                X                X    
                   X                                    X      X             X   X          X X      
           X      X    X      X XX  X   XX   XXX     X          X      X   X                         
                       X  X X           X      X      X   XX     X      X        X                   
               X         X X      XX X       X   X                                                   
 XX   X    X  XX        XX   X             X X          X  X                                         
       X      X     X      X      X           X                             X                  X  X  
 X    X                               X X X        X X                     X  X          X           
               XX    X               X         X                 X           X           X           
                      X          X    X           X       X         X          X    X  X      X      
           X   X         X                      X      X X  X           X X X  XX   X X     X        
   X                    XX       X                 X        X        X XX    X                X      
  X         X                 X  X    X                           X          X   X       X X         
                         X        X XX                           X X           X      X          XX  
        X     X X    X     X   X      X      X            X     X X             X         XX       X 
 X  X   X       XX X      X                                XX           X XX               X XXX     
                           X      X       X       X                     X                        X   
X             X       X                X     X      X  X     X              X          X    X     X  
    X    X     X X  X  X      X          X X                      X       X    X X     X             
       X           X         X        X      X                                X                      
   X    X         X     X                    X         X         X       X X         X     X         
          XX                       X    X          X         X X        X  XX       X       X        
       X           X       X       X           X X XX              X              X X         X      
            X                             X X       X          X               X              X    X 
            X          X    X                     X                                                  
                                            XX      X   X X           X               X      X       
   X  X                         X   X                         X               X X             X      
      X                   X   X  X         X  X       X                            X     X        X  
   X   X      X X     X                           XX                                             XX  
             X         X    X                          X                X     X          X           
  X                           X         X              X       X                X    X    X          
                         X                              X                                            
    X             X         XX              X       X  XX   X             X                         X
X      X              X   X           X  X  X      X X     X   X                  X         X     X  
                     X       XX        X    X                X  X          X            X            
  X XX        X   X  X                               X             X    X  X    XX       X   X    X  
                       X                     X X X            X           X     XX    XX        X  X 
     X                 X                  XX              X          XX         X           X        
                                   X   X           X         X    X    X        X    XX X       X    
      X X           X                                   X         X          X   X   X   X           
           X                        X         XX                  X       X     X                    
                X       X   X          X         X                                        X X X      
     X         X                     XXX                           X         X     X      X X   X    
                                                              X                      X      X X      
        X   X  X     XX                            X               X                           XX    
     X    X        X  X   X X             XXX                    X               X X                 
X   XX              X X          X       X           X                          X  X  X              
 X           X       X                   X                X X              X          XXX X          
                        X X      XXX               X        XX         X                             
  X        XX        X                                   X          X              X   X     X       
X             X       X                  X    X       X      X                   X    XXX   X        
  X        X         X   X      X XX                X     X  X  XX    X                              
   X     XX             XX    X X         X         XX            X              X        X       X  
                               XX       XX   X     X                 X   X                     X    E