SX                        X X      X        X            X                                     X X   
    X   X   X  X                     X       X     X   X       X                  X                XX
                          X   XX             X X  X       X     X           X           X     X      
     X        X   X        X                X          XX X   X               X         X            
                X    X X                  X         X      X  X     X X      X          X            
     X                      X             X    XX   X X  X  X         X            X         X       
   X                           X X                 X           X         X                   X     X 
  X            X X     X    X    XX                  X                     XXX   X    X           XX 
     XXX          X           X     X      X    X            X                                       
       X          X             X     X     X  XX           X             X           X    X X       
      X         X  X        X                    X     X    X  X           X                     X   
  X    X                     X    X                X                         X   XX X           XX   
                      X               X               X       X   X                   XX X  X        
   X                     X    X                           X          X       X         X             
                 X   X                  X XXX    X            X   X                                  
X             X   X  X     X XX               XX XX        X           X  X X  X                     
             X        X                      X       X       X       XX             X X      X       
  X      XXX    X X         X       X     X   X      X                  X       X    X         X  X  
    X         XX              X     X                     X            X    X                    X   
      X   X X          X       X      XX X              X        X           X  X             X      
          X                     X X  X                       XX    X    XXXX X                       
X               X   X  X X                          X  X                  X    X          X      X   
  X                    X    X  X   X                                      X        X X           XX  
X       X              X   X  X  X     X             X  X                 X   X          X      X    
         X   X    X            X          X                XXX   X  X                             XX 
     X        X                X     XX    X   X                   X  X      X     X                 
           X        X X                 X  X X               X    X    XX XXX   X            X XX  XX
X   X                        X                                 X  X   X                    X         
              X  X              X   X  X           X     X                               X   X       
             X     X  X              X            X   X    X      X  X             X    X           X
     X      X                                             X            X          X        X  X  X  X
      X       X                  X                                      X        X                   
      X    XX      X X    X   X                                   X        X X    X              X   
X              XX             X       X  X X  X         X                       X       X            
         X   X     X  X                                X              X               X     X        
   X        X  X X                          X          X X        X           X            X         
             X              X                            X    X  XX X         X     X                
         X   X           X        XXX              XX                             X X    XX X     X  
 XXXX           XX          XX                          X       X                  XX                
X                 X                      X              X    X       X     XX   X X    X X           
   X   XX             X       X     X X                                  X    X X       X            
     X              X            X    X             XX                X                        X     
    X           XX   X            X           X   X      XX         X                X    X   X      
        X X             X     X                       X          X  X           X            X       
  X        X      XX   X                            X   X X  X XX X             X                    
   X       X          X   X                   X      X     X       X       X             X           
                  XX X X   X     X    X           X            X           X X    X                 X
   XX                           X   X               X            X                 X    X X      X   
           X X              X          X             X  X      X    X    X   X        X              
    X                  X          XX  X        X            X                  X            X        
      X      X                           X                     X   XX X         X     X   X   X      
              X    X  X      X             X                               X                X     X  
     X XX X           XX     XX                    X     X  X         XX          X             X X  
   X      X         X     XX         XX     XX     X  X            X                         X       
 X    X      X                  X      X        X                              X                X  X 
     X               X   X     X    X    X    X              X              X   X                    
                                      X       X      X                   X          X X X    X       
  X                      X       X XX    XX       XXX               XX                 X      XXX    
                 X                X   X      X          X     X         X                            
    X                  X     X           X          X      X   X                  X              X   
         X     X      X              X                    X                   X          X   X       
    XX            X   X      X    X               X            XX                X X               X 
                      X               X        X   X    XX  X        X              X             X X
    X      X       X    X                        X           X          XX     X     X    X       X  
    X          X   X                 X                              X     X   X X  X                 
X          X  X           X               X            X          X X              X   X         X   
        X X      X              X X                   X     X       X      X      X                  
    X               X                X                                        X                X     
 X                    X  X     X    X                X   X          X             X        X       X 
    X                                                    X           X  X X             X     X     X
          X   X  XX            X    X            X    X    XX                  X          X          
X     X   XX              X   X                  X X     X                                          X
                     X  X                 X    X           X         X  X      X                     
X                 X       X             X X        X                    X                   X   X    
                        X X   X XX      X  X  X  X   X    X   X    XX            X        XXX    X   
   X   X   X X       XX             X                          X         X   X    X      X           
   X                     X                     XX X          X       X             XXX         X    X
              X   X               X                       X        X X    XX          X  X X  X      
  X     X     X    X        X     X        X                      X                           XX     
  X    X                         X     X   X    XX X         X              X X  X    XX       X     
         X     X             X           X         X                      X    X  X  X      X        
                          X   X     X      X                      X  X      X                        
        X         X XX                         X           X  XX           X           X             
     X          X      X      X X        X   X                        X        X          X          
     X   X                         X    X           X    X                                    X   X X
 X   X        X X   XX                   X X   X X   X      X                X         X            X
     X     XX                                   X  X  X             X       X   X                 X  
        X            X   X      X                X      XX          X  X         X   X      X        
  X       X                  X                      X  X                          X             X    
       XXX   X         X     X   X               X                    XX  X               X X        
X        XX               X            XX                         X              X         X         
                               X  X          XX                                 X                 X  
    X         XX                X    XX   X   X      X                X     XX                       
                                       X                        X    X           X             X     
    X X                  X         X                   X    X     X X            X                   
 X             X      X   X                   X            X                     X    X       X      
           X                          X  X       X     X   X          XX                            X
               X           X  X                   X           X               X          X           
                               X  XX     X X     X  X         X   X              X X          X      
                 X   X     X                                X  X XX      X         X                 
         X            X          XX                   XX                   X         X            X E