S                              XX       X         X                               X                  
    X               X    X               X                X         X           XX        X          
             X   XX     X      X                        X XX              X                  X       
                 X  X   X         X  X       X               XX                      X XX  X   X X   
X              XX              X                                  X                           X      
   X X    X     X     X     X  X     X     X X    X         X   X          X             X           
                  X                   XX         XXX   X      X            XX                 X X    
  X         X    XX       X                                                X                   X     
         X                X  X             X    X                   X    X                       X   
    X     X                      X X X                        X   X             X       X   X        
     X X              X X               X      X               X  X X             X X                
                    X           X                             X                                  X   
X X        X            X                     X                                X X          X      X 
            X  X      X               X      X                     X                  XX     X       
          X X                 X    X                          X    X                       X         
                      X      X           X            XX   X X                 X              X      
                                                  X     X   X            X    X   X                  
  X X                   X         X                X            X                      X             
 XX      X           X                 X   X X                 X                   X      X   X X X  
                        X               X    X     XXX                      X                     X X
    X     XX         XX  X        X                  X      X    X      X        X     X             
              X     X   X        X    X X                    X        X   X                          
              X                           X                     X             X                      
      X                         X                            X  X   X                    X      X    
 X               X                               X       XX                 X      X      X       XXX
   X    X              X        X      X        X          X                                         
X   X          X  X X    X              X        X                  X      X         X       XX      
                X                 X      X  X              X      X           X    X        X X      
      X       X        X                                                               X         X   
            X              X                XX    X            X  X              X     X          X  
           X    X               X          XXX     X                   X      XX                     
  X     X XX XX                    X                   X                        X  X      X          
                     X      X   X   X           X          X     X XX              X           X     
    XX                                             X         X     X               X   X   X         
       X                       X  X     X       X    X    X    X  X X       X                        
X   X X                      X       X                X  X   X        X      X X                 X   
       X          X    X        X           X  X     X                   X               X   X   X  X
X       X      X XX         X    XX   XX            X XX             XXX         X           XXX X   
     X     X       X                     X                     X                           X       X 
              X    X X X      X                   X   X                                            X 
                    X      X              X                   XXX           X   X X     X            
                            X               X      X         X           X            X        X     
      X                            X    X     X             X X                    X                 
 X             X           X  X         X     X       X  X                     X        X            
XX  X    X               X X  X                                                      X              X
                                        X               X      X         X X       X   X             
         X   X                   X    X     X                 X    X        X               X   X    
      X        X                                     X   X                   X         X       X     
 X     X                                       X  X        X                              X          
    X     X       X   X       X                                    X       XX                   X    
     X                X     X       X    X                  X              X       X     X           
      X       X     X       X                          X                    XX       X            X X
       X              X X      X    X  X   X       XX      X     X  X X       X X   XX        X      
                              XX         X  X    X      X    XX X   X     X  X  X           XX       
             X X                   X  XX         X                     X     X        X   X     X X  
        XX    X         X X          XX                      XX   X       X       X                  
                                           X   X  X          X    X    X     X     X   X             
   X                        X   X      X                 X    X                  XXX                 
              X  X    X            X             X   X              X         XX          X XXX     X
    XX     XX  X   X             X   X            X                         X   X X               X  
             X       X                          X      X             X   X        X   X       XX X   
    X      X     X           X     X             X       X             X        X              X     
        XX             X   X    X                          X             X          X    X           
X X                    X    X X             X X                   X                X  X       X      
                 X                          X                     X     X  X      X   X   X  X       
        X    X      X          XX          X       X            X          X         X               
       X         X                         X  X      X                X        X                 X   
        X                 XX                  X       X     X X    X       X     X      X   X        
         X X                X X                     X   X                            X             X 
                                                X   X X XX       X             X            X        
          X          X                       X         X      X                     X                
  X                   X                                                X     X                       
   X                         X                X       X            X X                      X X      
          X X       X             X              X       XX  X                       X        X    X 
        X       X X        X X       X               X             X                       XX        
       X   X        XX X                 X               X              X                    X     X 
              X                          X   X XX                   X            X            X   XX 
                   X       X                 X      X     X                                 X    X   
             X  X            X      X             X           X  X X    X                     X      
             X                     X                   X       X               X  X                  
             X                                    X         X                     X        X X   X   
           X     X  X  X      XX                       X            X                                
X            X          X                   X                X   X       X                           
    X          X    X  X               X   X X   X      X                 X    X                     
          X       XX                X       X    X       X      X             X      X      X        
X   X         X                       X          X X          X        X X    X      X        X      
X       X              X                                 X                X    X X   X    X  X   X   
                             XX   X            X                                        X X          
       X      X            X        X  X                          X                      X  X   X  X 
    X                                             X                                X     X           
      X      X               X                X               X    X     X         XX X   X         X
X     X          X X    X     X  X XX                                     X    X    X X X           X
          X                X         X                       X          X   X   X       XX           
        X   X        X       X    X        X        X            X X               X             X   
          X      X                     X         X        X X    X      X         X X                
      X                            X           X                              X              X      X
            X  X    XX X       XXX X        X                          X  X                X     X   
   X        X          X        X              X                               X     X               
         X        X      X       X                                            X                   X  
      X       X X      X       X X           X X X        X                X    XX   XXX     XX   X  
  X         X          X       X       X          XX        X  X                X               X   E