S X  X X           X          X  X           X X                   X        X       X               X
                            XXX       X    X                               X        X        X       
X    X X X      X                     X                    X                                X        
           X   XX  X    X X     X    X       X      X X X         X       X       X                  
             XX                   X  X    X       X         X X     X XX      X                      
                     X           X         X              X             X               X            
    X X                                  X  X   X                                       X            
                  X  X    XX X   X  X X            X           X  X                 X       XX    X  
      X       X X     X   XX        X X      X                            X X                X       
              X     X                                      X                             X    X      
      X        XXX      X                 X                      XX          X                       
   X      X     X    X            X                                             X                    
         XX      X    XX                                                  X             X    X    X  
     X   X X                    X    X    X          X   X     X   XX XX   X            X X    X   XX
  X   X        X         X  X             X  X                    X                      XX   X   X  
            X        X     X     X                                         XX                     X X
           X X    X             X     X       X       X     X XX   X X              X      X         
      X       X    X           XX           X             XX                      X      X  X        
     X XX                             X   X              X           X               X               
              X                               X                     X      X         X X             
   XX        X X      X       X               X               X              X            X          
      X                    XX  X     X  X                 X  X                      X  X X X    X    
          XX  X   XX        X                     X      X   X                          X            
                       X  X      XX                      X  X    X      X    X  X     X              
                                       X X  X        X   X X    X     X                  X           
           X                        X                                  X                           X 
  X        X                 X                          X   X X X X    XXX                           
  X     X X          X                    X        X                 X                               
   X                 X  X X           X     XX   X                              X  X   X  X          
                                         XX            XX              X                             
              X   X   X       X                   X                          X     X             X   
     X  X      X   X              X      X X X    X   X           X X                   X        X  X
               XX                            X              X  X              X          X      X    
               X                     X                   X                      X   X         X      
          X                   X    X  X     X                 X X X               X      X    X      
                                              X      X X    X                 X      XX              
X   X         XX               X                X                          X      X    X             
   X             X   XX  XX            X X       X     X                 X   X        X     X        
X X   X     X         X X   X                               X     X                   XX    X   X X  
 X  X     X     X      XX              X    X                X XX    X     X                       XX
X        X         X     X  X            X     X  X   X          X      X             X          X   
X                 X X                      X       X      XX  X             X X  X       X           
X                   X X              X       X     X X     XX      X          X            X  X      
       X           X       XX   X X         X                     X X    X            X          X   
             X X                 X         X         X                      X X            X         
                   X X      X   XX  X    XXX             X                     XX                X XX
                       XX X            X           X                X    X   X X            XX X     
  X                              XX  X X          X   X    X       XX        X  X X         X  X     
XX    X                       X        X        X X                    X     X                XX     
             X                            X           X              X            X                X 
       X         X X                                    X     XX          X          X    X          
                        X              X                      X XX             X    X                
           X             XX      X      X              X            X   X        X X       X         
X        X        X       X                   X      XX X      X           X  X   X                  
X    X    X     X             X  X          X  X                      X      X X  XX                 
                     X  X X      XX          XXXX     X  X     X         X        XX     X   XX      
        X X               X            X                X         XX       X       X        X        
         X      X                      X         XX              X          X X       X X        XX  
  X                                  X                X    X                X  X     X   X           
  X        X               X                   XX              X  X                            X   X 
  X             X                         XX           X        X                       X      X     
                  X                X X            X     X        X      X   XX    XX            X    
          X  X          X      X     X            X X  X      X       XX            X  X X        XX 
   X        X          X          X                                             X   XX X    X     X  
   X     X                                                X      X X       X                  XX     
                  X   X   X       X   X  X X     X X            X               X X  X X X      XX X 
     X      X        X    X         X                          X       X             X        XXX    
     X    X      X  X     XX                X                       X   X            X               
             XX    X  X           X       X                                    X   X    X       X X  
X          XX     X     X     X     X     X   X         X   X  X                                     
         XX   X   X        X       X X   X        X            XX                        X         X 
 X XX      X    X             X        X X         X  X   X    X          X             X            
 X              X          X   X                                         X                           
                X                        X                    X X          X    X       X            
     X X   X   X      X        X   X     XX    X             X         X X        X    X             
 X          X  X   X     X X         X       X       X      X   X    X  X X                    X     
         X      X          X            X   X             X     X      X X  X X                      
X             X        X                    X X  XXX  X X             X    X                    X    
                              X           X           X            X X        X                      
               X             X     X     X  X      X                        X            X  X        
XX            X   X             X            X    X              X  X             X  X          X    
    X  X             X                   X XX   X                X                X    X  XX         
                            X                     X       X            X             X   X       XX  
                           X         X                X     X X X  X   X                  X          
      X              X                           X   X    X       X   X             X                
  XX    X                  X       X                     X   X                 X X     X         X   
 X       X          XX X      X   X        XX                     X                        X         
                     X                               X                                    X  XX      
            X                       X               X      X             X      X             X      
           X   X             X     X           X      X      X            X     X     X      X       
               X X     X    X X         X           X        XX  XX X            XXX             X   
       X       X   X                            X        X                  X             X X       X
              X               X  X X X   X                 X      X  X    X           X        X     
                     X         X        X             X                          X   X        X      
         XX           X   X       XX                      X              X        X        X  X      
       X      XX  X         X    X    X  X      X                    X X               X             
       X                   X   X                    X        XX XX      X   X         X             X
       X                   X  X                        X         X   X         X  X    X          X  
         X          X  X         X                XX X       X  X        X             X             
              X               X         X      X      X   X    X       XX       XX X         X      X
                     X                 X                X       X  X                               XE