S                            X                 X           X  X  X  X            X     X            X
         X    X X        X  X X        X        X X                X               X             X   
           X        X          XX        XX     X               X  X     X                X          
                          X        X                                X    X   XX        X             
 X       X                X  X    X   X X      X                XX         X           X    X        
            X        X     X       X  X          X       X                         XX      X      X  
               X X X  XX       X          X     X                       X                 X    XX    
   X           X            X                   X     X      XXX     X            X       XX      X  
                                         X     X X                      X       XX          XX       
       X              X                       X X      X                     X X                     
       X   X              XX         X X                  X                            X             
                               X  X        X                             X           X            X  
 X X    X     XXXX       XX        X       X   X         X XX                          X             
    X  XX                  XX                             X X X   X                         X        
X X   X     X X   XX      X X    X XX                X          X     XX    XX    X   X              
                               X   X        X X       X            X           X                 X X 
 X                                     X  X   X      X  X X    X   X      X         X                
                         X  X    X    X    X  XXX                X             X    X              X 
    X  X              X             X     X                   X       X XX    X    X X X          X  
  XX X X X                                                   X X X  XX    X X    X   X         XX    
       X              X  X                X   X  X                      X               XX        X  
        X    XX      X                  X X         X       X     X        X    X          XX  X     
 X           X         X             X      X      X                     X   X           X        X  
           X        X            X            XX    X                               X        XX      
 X       XX   XXX    X                  X    X      X  X   X                               X         
           X           X X                          X          X X   X X  X  X     X  X       X      
    X                            X    X      X    X        X           X             X    X  X  X    
    X             X   X            XX        X        X  X    X      X   X                           
                                                                                                X X  
             X                           X           X      X      X X   X    X                      
XX         X     X     X  X X            X   X     X          XXX          X                         
                X     X       X    X       X X      X X                  X         X      X  XX      
                     X  X              XXX X   X X X          X      X     X   X            X        
         X      X                                              X                      X              
             X   X                                X     X X            X              X              
                                       X                X     X     XX         XX   X  X      XXX   X
          X               X     XX  X      X                  X XX           X  X X    X             
 X      X      X           X           X                              X    X          X              
               X    X             XX                            XX                       X           
                 X X  X   X     X                  X      X               X  X          X    X       
  X                XX                         X       X        X       X                        X X  
  X    X  X     X    X      X                X   X       X        X  X X        X      X    X    X   
          X              X   X          X   X        X    X   X         X                            
     X     X       X X X  XX    X   X         X   X     X                      X X                   
     X X  X                         X     X          XX                      X      X                
       X   X                                X           XX   X            XX     X    X       X      
                X      X                              X   X                 X  X   X        X XX X   
XX                X        X                 X X            X    X       X                           
   X         X           X         X        X      X  X                      X       X     X         
                       X                  X X     X  X  X                X   XX X               X    
                    X            X X              X  X         X          X                      X   
  X       X       X                    X X       X                     X X       X   X     X         
           X               X X X X       X  X               X  X   X    X          X   X     X       
                     X            X      X      X              X   X             X                   
X    X                       X           X         X                     X X                         
         X X       X    X      X        X    X              X        X     X  X     X     X  X       
   X  X  X X             X         X                 X XX XX             X  X              XX XX    X
X                          X                X          X  XX   X    X X    X             X           
                 X                X    X                         X  X     X  X    X X     X X X    X 
         X                     X       X   X          X                      XX          XX          
  X  X          X                           X X     X           X XX                X                
    X    X         X      X X        X              X X    X                X  X  XX        X        
       X     X      XX X       X             X   X                    X X         X            X X   
 X                  X          XX    X         X   X    X  X X          X    X     X                 
                  X   X   X                                    X     X X         X          X        
               X  X     X   X              X           X         X                   X X   XX X      
            X X               X                                               X        X             
X       X X      X            X            X     X                X                     X     X      
                               XX                  X                 XX          X                   
      X                          X  X         X        X  X            X   X              X          
XX    XX                   X    X     X              X    X   X           X   X                      
               X    X                X    X             X    X           X      X X     X   X        
     X                               X     X                   X              X X              X    X
         X    X   X   X    XX                   X  X X   X     X                     X     X    X  X 
     X    X                   X                  X                 X            X            X   X   
      X     X XX    XXX                      X      X X                        X      X     X        
X     X X    X X    X           X XX          X                            X              X          
       X X               XXX                    X X              X  X        XX                    X 
        X             X   X       XX              X                             X                    
                     X     XX                        X    X                XX     X             X    
    X           X   X           X                                        X           X   X    X     X
                   X    X   X    X                        X    X           X          X              
 XXX      X                  X X              X       X  X    X    X   XXX          XX  X            
                                  X X    X  X             XX          X    X              X          
                     XX                                     X    X                          X        
      X        X  X            X              X                                    X              X  
       X     X                  X  XX             X  X                             X      X          
                    X  X    X  X    X        X                           X                   X       
    X                    X X          X      X           X X   X      X X   X         X   X          
      X X                     X                X       X  X           X        X         X    XX     
X            X    XX  X               X   X X                              X            X            
        X         X       X X XX             X              X                   X           X       X
X     X                     X   X   X                                                 X   X     X X  
        X   XX        XXX                           X       X      X      X  X  X               X   X
          X                                                  X    X                           X      
   X             X            X  X            X X        X          X                        X       
   X  X              X  XX   X    X            X              X X                X  X              X 
  X       X    X X          X             X              X  X               X   X   X  X          X  
     XX    X        X X         X                           X                X    XXX              X 
   X                X           X                        X          X X      X               X       
  X X       X     X                          X  X X           X            X              XX X      E