S            XX         X          X    X        X         X            X   X                  X     
    XX    X      X X         X    X          X           X      X                   X                
           X     X                              XXX         X                        X           X   
    X            X     X             X          X                  X            X                    
X     X       X   X                           X                   X     X        XX                  
       X                  X         X                          X                              X     X
    X   X             X              X    X             X X  X                 X                     
       X        X                                X       X X           X          XX     X           
   X  X   X                     XX    X              X            X           X               X X  XX
         XX                     XXX         XX   X            X X             X  XXX X               
       X                                   X  X         X      X     X                   X      X    
   X  X     X                            X    X     X     X          X             XX       X    XX  
             X               XX    X  XX    X X               XX                  XXX     X   X      
          X                       X        X        X              X      X            X             
    X  XX      X X            X                   X         X   X          X  X                   X  
       XX                                X              X        X  XX  X      X          X         X
   X                   X  X    X XX    X     X                                        XX     X X     
     X   X          X    X   XX       X            X       X  X              X                       
                                                     XX     X  X           X      XX  XX     X       
X X                XX          X         X              X          X    X        X           X       
  X      X  X         X    X   X                             X                                  X    
    X                X      X       X X                  X    X         X          X               X 
       X     X       X                X                 X       X           X                X       
                             X    XX                         XXX         X  X                X X     
        X     X       X                          X        X          X       X     X                 
       X       X                 X                 X   X                                             
            X     XX         X         X     X       XX          X         X   X       X    XX  X  X 
        X    X   X    X         X      X       XX                      X    X X  X X      X        X 
        X        X  X     X      X       X            X       X                                    X 
   X    X     X X                X     X     X        X   X XX X              X    XX   X     X    X 
   X X      X X        XX        X X       X            X     X  X                 X   X        X    
                            X          X                X                    X   X     X            X
      XX     X     X       X     X                    X           X     X        X        X  X      X
                X                                                                 X           X      
    X   X             X                                      X   X                          X    X   
    X                      X          XX     X       X  X X                                          
 X   X             X                                    X         X  X   X      X    X      X        
            X   X      X         X                             X          X                          
    X       X           X             X   X                           XX           X                 
              X    X                                                 X    X         X      X X      X
 X       X       X X    X     X          X X      X     XX   X      X  X  X X       X    XX          
                        X     X       XX X                  X         X                      X       
           X    X                         X          X        X       X                 X            
          X       X                X                          X    XX                                
         X                XX               X         X  X X           X                     X    X X 
             X  X                  X   X     XX         X       XX                     X X X         
        X          X          XX       X                     X        X    X     X    X     X        
   X              X X      X                               X  X              X     X  X  X           
         X    X   X         X   X  X   X    X                 X                    X   X             
                              X  X       X     X        X  X            X    X    X  X    X          
             X       XX              X                                         X        X            
         X X  X          X       X  X                  X      X                       X              
  X             X X    X                          X          X              XX         X    X        
 X X       X                             XX      X  X         XX XX             X X                  
     X               X X    X X        X                               XX   X                X    XX 
                                   X                                X   X           XX    X       X  
            X  X          X               X         X         X X X         X    X                   
  X                   X      X          X        X X           X       X                             
   X        X                 X                   XX                   X                  X          
          X       X         X X  X      X X       X     X        X     X X     X  X  X       X       
               X      X   X             X              X                   X                    X  X 
  X                X    X                X               XX X    X                              X    
            X          X                 X X            X                                            
X   X           X             X                         X        XX                    X             
  X      X                      X                X                   X      X     X                  
  X           X         X    X   X     X                 X            X    XX                        
                XX    X   X     X XX      XX    X      X  X      X  X   X               X            
      X   X                          X           X             X              X                      
    X            X  X                   X                                  X   X                     
     XX      X                                                       X   X    X     XX         X   X 
     X         X      X              XX         X                X   X      X    X X    X X          
               X      X      X X              X                   X               XX   X X          X
         X      X                   X   XX                   X              X  X            X        
                      X                                     X   X     X X        X                   
              X               X      X    XX                    X            X           X  X        
XX    XX               X  X         X    X         X    X           X         X      X        X     X
                  X        X        X                X               X            X                  
                      X  X      X      X               X  X         X     X      XX          X       
            X         X                    X   X        X   XX          X X   X    X                 
                           X          X     X    X            X  X X         X              X        
      X              X X             X             X X                  X X            X             
        X       X         X  X                      X                      X          X           X  
       X   X      X     X             X            X               X                X        X    X  
        X X                  XX      X  X     X     X        X      X   X            X               
                X               X   X     X      X         X                            X           X
X   X          X                        X      XX X X   X       X  X                        X XX     
                                  X XX       X                 X     X                 X             
     XX   X  XX                  X           X      X          X                  XX       X    X    
        XX                    X         X                                      X  XXX             X  
   X                X   X            X                    X                                X       X 
       X        X X              X X            X          X         X  X         X         X        
   X X     X        X                                          X          X   X   X                  
  XX     X X          X         X                               X     X              X      X   X    
   X X    X                   XX         X              X    X            X                          
           X                X           X    X               X       X        X              X X     
    X      X X   X  XX                 X  X   X  X   X                       X  X       X X    X     
   X        X                   XX       X                          X    X     X   X    XX           
                XX            X  X        X  X       XX X     X    XXX              XX  X         X  
   X X         X  X          X         X   X                     XX   XX      X                      
        X    X    X     X         X    X     X      XX         X                                X    
              X   X X                       X        X                       X X                    E